###########
#A#       #
# #B##### #
# # ##### #
#         #
###########