##########
A ##   ###
#  # # ###
##   #   #
#### ### #
#    ### #
# ########
#     ####
#####    B
##########