##########
#A     # #
# ## # # #
#  # # # #
#### # # #
#    #   #
# ### ####
# #      #
# ### ## #
#     #B #
##########
