###############################
A #       #     #    #        #
# ## ### ### ### ## ## ##### ##
#      #       #  #     # ## ##
# # #### ##### ####### # ### ##
#    #    #      #         #  #
# ## # ####### # ### ##### #  #
#    # #   #   #             ##
# ## # # # ### ##### ####### ##
# #  # # #   # #       #     ##
# #### # ##### # ####### ### ##
#      # #     #   #   ##    ##
# #### ### ### ##### #  ## ####
#      #   # #       ## ##    #
# ####### ### ####### # ##### #
#         #     #     #   ### #
# ### ##### ####### ##### ### #
#     #   #   #    #          #
# # # # ##### ##### # ### ### #
# # # # #   #       # #       #
# ### # # # ### # # ### ##### #
#     # # # #   # #     #     #
# ### # # ### ### ####### #####
#     # #     #   #     #     #
# ### # # ### # ### ### ##### #
# #         # #     # #     # #
# # ####### ### ### # ##### # #
# #         #   #   #     #   #
# ######### # ### ##### ##### #
#                             #
###########B###################
